BBBBBBBBBBBBBBBBBBBBBBBBBBBBBB
B0000000000000000000000000000B
B0000000000000000000000000000B
B0000000000000000000000000000B
B0000000000000000000000000000B
B0000000000000000000000000000B
B0000000000000000000000000000B
B000000000WWWWWWWWW0000000000B
B0000000000WWWWWWW00000000000B
B00000000000WWWWW000000000000B
B000000000000WWW0000000000000B
B0000000000000W00000000000000B
B0000000000000000000000000000B
B0000000000000000000000000000B
B0000000000000000000000000000B
BBBBBBBBBBBBBBBBBBBBBBBBBBBBBB